############
#        O #
#  P    ####
#          #
####### #   #
#  O ## #   #
#    ##    #
#          #
#          #
#      XX  #
#      #   #
############
